Date,narration,Value Date,Debit Amount,Credit Amount,Chq/Ref Number,Closing Balance
02-04-2023,NEFT_IN:BARBX23093652384/0043/ SANJAY BAPU KADAM,02-04-2023,,10000,,13658.78
05-04-2023,UPI/534526174151/P2M/amazonpaybalanceload@apl/Flipkart,05-04-2023,,16000,,29658.78
05-04-2023,NEFT CR-ICIC0099999-GODREJ AND BOYCE MFG CO LTD-MANDAR SANJAY KADAM-CMS3471397262 G B SALARY CREDIT FOR THE MONTH OF,05-04-2023,370,,,29288.78
05-04-2023,UPI/309566075656/P2M/amazonupi@apl/AMAZONPA,05-04-2023,719,,,28569.78
07-04-2023,ATM Cash Withdrawal - ICICI Bank ATM,07-04-2023,,310,,28879.78
07-04-2023,FD THROUGH NET-50305210051755:MANDAR SANJAY KADAM,07-04-2023,120,,,28759.78
09-04-2023,NEFT CR-ICIC0099999-MANDAR SANJAY KADAM-CMS3285958840,09-04-2023,,120,,28879.78
09-04-2023,ECOM 309801975933 Paytm_AgodaCompanyPTEL\,09-04-2023,4239.17,,,24640.61
09-04-2023,NEFT CR-ICIC0099999-GODREJ AND BOYCE MFG CO LTD-MANDAR SANJAY KADAM-CMS3867207735 G B SALARY CREDIT FOR THE MONTH OF,09-04-2023,990.81,,,23649.8
10-04-2023,NEFT SANJAY BAPU KADAM,10-04-2023,,1500,,25149.8
10-04-2023,FD THROUGH MOBILE-50300912834567:ANITA SHAH AUTO RENEWAL,10-04-2023,7900,,,17249.8
10-04-2023,UPI/409471978081/P2M/amazonpaybalanceload@apl/Indian Oil,10-04-2023,70,,,17179.8
10-04-2023,FD THROUGH NET-50367391394002:MANDAR SANJAY KADAM,10-04-2023,70,,,17109.8
11-04-2023,NEFT CR-ICIC0099999-GODREJ AND BOYCE MFG CO LTD-MANDAR SANJAY KADAM-CMS3581865273 G B SALARY CREDIT FOR THE MONTH OF,11-04-2023,12,,,17097.8
12-04-2023,ECOM 310105598871 Paytm_AgodaCompanyPTEL\,12-04-2023,1485.12,,,15612.68
12-04-2023,SMS CHRG FOR:01-01-2023to31-03-2023,12-04-2023,17.7,,,15594.98
12-04-2023,UPI/406175370910/P2M/q198608410@ybl/IRCTC,12-04-2023,150,,,15444.98
14-04-2023,NEFT_IN:BARBR23104882463/0044/ SANJAY BAPU KADAM,14-04-2023,,10000,,25444.98
14-04-2023,UPI/347029893938/P2M/gateoffice50.rzp@icici/INDIAN,14-04-2023,500,,,24944.98
15-04-2023,VREF/W01/UNI000/24881239030100,15-04-2023,,4239.17,,29184.15
15-04-2023,ATM Withdrawal MANDAR SANJAY KADAM,15-04-2023,15,,,29169.15
16-04-2023,Phone Recharge - Airtel,16-04-2023,,3,,29172.15
16-04-2023,ECOM 310618557393 FLIPKART PAYMENTS     \,16-04-2023,854,,,28318.15
16-04-2023,UPI/448346881114/P2M/q198608410@ybl/Flipkart,16-04-2023,80,,,28238.15
16-04-2023,NEFT CR-ICIC0099999-GODREJ AND BOYCE MFG CO LTD-MANDAR SANJAY KADAM-CMS3581581959 G B SALARY CREDIT FOR THE MONTH OF,16-04-2023,70,,,28168.15
17-04-2023,ECOM 310710049626 Indian Institute of Te\,17-04-2023,300,,,27868.15
17-04-2023,Internet Bill Payment - Jio Fiber,17-04-2023,180,,,27688.15
17-04-2023,LIC Premium Payment - Annual Plan,17-04-2023,150,,,27538.15
17-04-2023,NEFT CR-ICIC0099999-GODREJ AND BOYCE MFG CO LTD-MANDAR SANJAY KADAM-CMS3240762034 G B SALARY CREDIT FOR THE MONTH OF,17-04-2023,60,,,27478.15
18-04-2023,UPI/547252605029/P2M/q432198234@ybl/Burger King,18-04-2023,,500,,27978.15
18-04-2023,NEFT CR-ICIC0099999-GODREJ AND BOYCE MFG CO LTD-MANDAR SANJAY KADAM-CMS3887437298 G B SALARY CREDIT FOR THE MONTH OF,18-04-2023,500,,,27478.15
19-04-2023,Electricity Bill Payment,19-04-2023,145,,,27333.15
19-04-2023,Medical Insurance Premium Payment,19-04-2023,85,,,27248.15
19-04-2023,UPI/472460072558/P2M/q198608410@ybl/Swiggy,19-04-2023,150,,,27098.15
19-04-2023,FD THROUGH MOBILE-50348625738995:MANDAR SANJAY KADAM,19-04-2023,140,,,26958.15
19-04-2023,UPI/430794228785/P2M/googlepay@axisbank/Indian Oil,19-04-2023,15,,,26943.15
19-04-2023,FD THROUGH NET-50300898901234:SUMIT KUMAR PREMATURE WITHDRAWAL,19-04-2023,10,,,26933.15
19-04-2023,UPI/347502543155/P2M/q820504173@ybl/HP Petrol Pump,19-04-2023,270,,,26663.15
19-04-2023,UPI/406175370910/P2M/q198608410@ybl/IRCTC,19-04-2023,5,,,26658.15
20-04-2023,UPI/464616072856/P2M/googlepay@axisbank/IRCTC,20-04-2023,,1000,,27658.15
20-04-2023,NEFT CR-ICIC0099999-GODREJ AND BOYCE MFG CO LTD-MANDAR SANJAY KADAM-CMS3471397262 G B SALARY CREDIT FOR THE MONTH OF,20-04-2023,20,,,27638.15
20-04-2023,CREDIT INTEREST CAPITALISED,20-04-2023,350,,,27288.15
20-04-2023,NEFT CR-ICIC0099999-GODREJ AND BOYCE MFG CO LTD-MANDAR SANJAY KADAM-CMS3240762034 G B SALARY CREDIT FOR THE MONTH OF,20-04-2023,324,,,26964.15
20-04-2023,UPI/403322158045/P2M/googlepay@axisbank/Amazon,20-04-2023,687,,,26277.15
21-04-2023,IB FD PREMAT INT PAID-50302470776576,21-04-2023,539,,,25738.15
23-04-2023,FD THROUGH NET-50366774598193:MANDAR SANJAY KADAM,23-04-2023,136,,,25602.15
23-04-2023,UPI/430794228785/P2M/googlepay@axisbank/Indian Oil,23-04-2023,50,,,25552.15
23-04-2023,UPI/448346881114/P2M/q198608410@ybl/Flipkart,23-04-2023,8,,,25544.15
23-04-2023,UPI/467664603056/P2M/googlepay@axisbank/Myntra,23-04-2023,120,,,25424.15
23-04-2023,NEFT CR-ICIC0099999-MANDAR SANJAY KADAM-CMS3285958840,23-04-2023,15,,,25409.15
24-04-2023,CREDIT INTEREST CAPITALISED,24-04-2023,90,,,25319.15
24-04-2023,NEFT CR-ICIC0099999-GODREJ AND BOYCE MFG CO LTD-MANDAR SANJAY KADAM-CMS3851194819 G B SALARY CREDIT FOR THE MONTH OF,24-04-2023,50,,,25269.15
25-04-2023,Phone Recharge - Airtel,25-04-2023,105,,,25164.15
25-04-2023,NEFT CR-ICIC0099999-GODREJ AND BOYCE MFG CO LTD-MANDAR SANJAY KADAM-CMS3565932590 G B SALARY CREDIT FOR THE MONTH OF,25-04-2023,20,,,25144.15
25-04-2023,NEFT CR-ICIC0099999-GODREJ AND BOYCE MFG CO LTD-MANDAR SANJAY KADAM-CMS3686284545 G B SALARY CREDIT FOR THE MONTH OF,25-04-2023,36,,,25108.15
26-04-2023,CREDIT INTEREST CAPITALISED,26-04-2023,130,,,24978.15
26-04-2023,Phone Recharge - Airtel,26-04-2023,10,,,24968.15
26-04-2023,UPI/441521409876/P2M/q198608410@ybl/Swiggy,26-04-2023,650,,,24318.15
26-04-2023,UPI/474468662823/P2M/googlepay@axisbank/Flipkart,26-04-2023,15,,,24303.15
26-04-2023,NEFT CR-ICIC0099999-GODREJ AND BOYCE MFG CO LTD-MANDAR SANJAY KADAM-CMS3695735276 G B SALARY CREDIT FOR THE MONTH OF,26-04-2023,57,,,24246.15
26-04-2023,NEFT CR-ICIC0099999-GODREJ AND BOYCE MFG CO LTD-MANDAR SANJAY KADAM-CMS3036192248 G B SALARY CREDIT FOR THE MONTH OF,26-04-2023,60,,,24186.15
26-04-2023,NEFT CR-ICIC0099999-GODREJ AND BOYCE MFG CO LTD-MANDAR SANJAY KADAM-CMS3497137062 G B SALARY CREDIT FOR THE MONTH OF,26-04-2023,70,,,24116.15
28-04-2023,FD THROUGH MOBILE-50368759479576:MANDAR SANJAY KADAM,28-04-2023,230,,,23886.15
28-04-2023,UPI/457764899862/P2M/q198608410@ybl/IRCTC,28-04-2023,80,,,23806.15
29-04-2023,UPI/458468630745/P2M/googlepay@axisbank/IRCTC,29-04-2023,10,,,23796.15
29-04-2023,NEFT CR-ICIC0099999-GODREJ AND BOYCE MFG CO LTD-MANDAR SANJAY KADAM-CMS3024042348 G B SALARY CREDIT FOR THE MONTH OF,29-04-2023,10,,,23786.15
29-04-2023,NEFT CR-ICIC0099999-GODREJ AND BOYCE MFG CO LTD-MANDAR SANJAY KADAM-CMS3343559776 G B SALARY CREDIT FOR THE MONTH OF,29-04-2023,20,,,23766.15
29-04-2023,NEFT CR-ICIC0099999-MANDAR SANJAY KADAM-CMS3999378791,29-04-2023,25,,,23741.15
29-04-2023,NEFT CR-ICIC0099999-GODREJ AND BOYCE MFG CO LTD-MANDAR SANJAY KADAM-CMS3172137111 G B SALARY CREDIT FOR THE MONTH OF,29-04-2023,60,,,23681.15
29-04-2023,NEFT CR-ICIC0099999-MANDAR SANJAY KADAM-CMS3644333553,29-04-2023,380,,,23301.15
30-04-2023,CREDIT INTEREST CAPITALISED,30-04-2023,80,,,23221.15
30-04-2023,Hospital Bill - MANDAR SANJAY KADAM,30-04-2023,550,,,22671.15
30-04-2023,Medical Insurance Premium Payment,30-04-2023,120,,,22551.15
30-04-2023,UPI/431794200909/P2M/amazonpaybalanceload@apl/Myntra,30-04-2023,190,,,22361.15
01-05-2023,Electricity Bill Payment,01-05-2023,40,,,22321.15
01-05-2023,FD THROUGH NET-50367391394002:MANDAR SANJAY KADAM,01-05-2023,54,,,22267.15
01-05-2023,Internet Bill Payment - Jio Fiber,01-05-2023,120,,,22147.15
01-05-2023,NEFT CR-ICIC0099999-GODREJ AND BOYCE MFG CO LTD-MANDAR SANJAY KADAM-CMS3549474702 G B SALARY CREDIT FOR THE MONTH OF,01-05-2023,90,,,22057.15
02-05-2023,IB FD PREMAT INT PAID-50308648829057,02-05-2023,,21461,,43518.15
02-05-2023,FD THROUGH NET-50305210051755:MANDAR SANJAY KADAM,02-05-2023,,37908,,81426.15
02-05-2023,IB FD PREMAT PRINCIPAL-50355096688727,02-05-2023,60000,,,21426.15
02-05-2023,Phone Recharge - Airtel,02-05-2023,500,,,20926.15
03-05-2023,FD THROUGH NET-50371498812629:MANDAR SANJAY KADAM,03-05-2023,65,,,20861.15
03-05-2023,Medical Insurance Premium Payment,03-05-2023,6,,,20855.15
03-05-2023,UPI/464028838086/P2M/googlepay@axisbank/Flipkart,03-05-2023,10,,,20845.15
03-05-2023,NEFT CR-ICIC0099999-MANDAR SANJAY KADAM-CMS3953431365,03-05-2023,,80,,20925.15
03-05-2023,UPI/479758310791/P2M/googlepay@axisbank/IRCTC,03-05-2023,200,,,20725.15
03-05-2023,UPI/497171245639/P2M/amazonpaybalanceload@apl/Indian Oil,03-05-2023,15,,,20710.15
04-05-2023,NEFT CR-ICIC0099999-GODREJ AND BOYCE MFG CO LTD-MANDAR SANJAY KADAM-CMS3581581959 G B SALARY CREDIT FOR THE MONTH OF,04-05-2023,,120,,20830.15
04-05-2023,NEFT CR-ICIC0099999-GODREJ AND BOYCE MFG CO LTD-MANDAR SANJAY KADAM-CMS3641645486 G B SALARY CREDIT FOR THE MONTH OF,04-05-2023,25,,,20805.15
04-05-2023,FD THROUGH NET-50326587608055:MANDAR SANJAY KADAM,04-05-2023,120,,,20685.15
04-05-2023,UPI/458516593651/P2M/q198608410@ybl/Flipkart,04-05-2023,20,,,20665.15
04-05-2023,NEFT CR-ICIC0099999-GODREJ AND BOYCE MFG CO LTD-MANDAR SANJAY KADAM-CMS3486235810 G B SALARY CREDIT FOR THE MONTH OF,04-05-2023,120,,,20545.15
04-05-2023,NEFT CR-ICIC0099999-GODREJ AND BOYCE MFG CO LTD-MANDAR SANJAY KADAM-CMS3581865273 G B SALARY CREDIT FOR THE MONTH OF,04-05-2023,253,,,20292.15
04-05-2023,NEFT CR-ICIC0099999-GODREJ AND BOYCE MFG CO LTD-MANDAR SANJAY KADAM-CMS3055692398 G B SALARY CREDIT FOR THE MONTH OF,04-05-2023,870,,,19422.15
05-05-2023,FD THROUGH NET-50395039923740:MANDAR SANJAY KADAM,05-05-2023,1,,,19421.15
05-05-2023,UPI/472460072558/P2M/q198608410@ybl/Swiggy,05-05-2023,250,,,19171.15
05-05-2023,UPI/495715410571/P2M/amazonpaybalanceload@apl/Indian Oil,05-05-2023,50,,,19121.15
05-05-2023,NEFT CR-ICIC0099999-GODREJ AND BOYCE MFG CO LTD-MANDAR SANJAY KADAM-CMS3867207735 G B SALARY CREDIT FOR THE MONTH OF,05-05-2023,230,,,18891.15
05-05-2023,NEFT CR-ICIC0099999-GODREJ AND BOYCE MFG CO LTD-MANDAR SANJAY KADAM-CMS3311285081 G B SALARY CREDIT FOR THE MONTH OF,05-05-2023,250,,,18641.15
06-05-2023,Electricity Bill Payment,06-05-2023,35,,,18606.15
06-05-2023,UPI/409471978081/P2M/amazonpaybalanceload@apl/Indian Oil,06-05-2023,45,,,18561.15
06-05-2023,NEFT CR-ICIC0099999-GODREJ AND BOYCE MFG CO LTD-MANDAR SANJAY KADAM-CMS3869924394 G B SALARY CREDIT FOR THE MONTH OF,06-05-2023,15,,,18546.15
06-05-2023,NEFT CR-ICIC0099999-GODREJ AND BOYCE MFG CO LTD-MANDAR SANJAY KADAM-CMS3513962730 G B SALARY CREDIT FOR THE MONTH OF,06-05-2023,70,,,18476.15
06-05-2023,NEFT CR-ICIC0099999-MANDAR SANJAY KADAM-CMS3926061397,06-05-2023,105,,,18371.15
07-05-2023,NEFT CR-ICIC0099999-GODREJ AND BOYCE MFG CO LTD-MANDAR SANJAY KADAM-CMS3976846371 G B SALARY CREDIT FOR THE MONTH OF,07-05-2023,,10000,,28371.15
07-05-2023,UPI/484917246437/P2M/q198608410@ybl/Amazon,07-05-2023,3217,,,25154.15
07-05-2023,NEFT CR-ICIC0099999-GODREJ AND BOYCE MFG CO LTD-MANDAR SANJAY KADAM-CMS3520890650 G B SALARY CREDIT FOR THE MONTH OF,07-05-2023,100,,,25054.15
07-05-2023,NEFT CR-ICIC0099999-MANDAR SANJAY KADAM-CMS3276009408,07-05-2023,220,,,24834.15
09-05-2023,Hospital Bill - MANDAR SANJAY KADAM,09-05-2023,70,,,24764.15
10-05-2023,ATM Withdrawal MANDAR SANJAY KADAM,10-05-2023,270,,,24494.15
11-05-2023,FD THROUGH MOBILE-50348625738995:MANDAR SANJAY KADAM,11-05-2023,190,,,24304.15
11-05-2023,Internet Bill Payment - Jio Fiber,11-05-2023,20,,,24284.15
11-05-2023,Medical Insurance Premium Payment,11-05-2023,140,,,24144.15
11-05-2023,Phone Recharge - Airtel,11-05-2023,25,,,24119.15
11-05-2023,NEFT CR-ICIC0099999-GODREJ AND BOYCE MFG CO LTD-MANDAR SANJAY KADAM-CMS3068454046 G B SALARY CREDIT FOR THE MONTH OF,11-05-2023,25,,,24094.15
12-05-2023,Hospital Bill - MANDAR SANJAY KADAM,12-05-2023,110,,,23984.15
12-05-2023,Phone Recharge - Airtel,12-05-2023,102,,,23882.15
12-05-2023,NEFT CR-ICIC0099999-GODREJ AND BOYCE MFG CO LTD-MANDAR SANJAY KADAM-CMS3940394806 G B SALARY CREDIT FOR THE MONTH OF,12-05-2023,290,,,23592.15
13-05-2023,UPI/470386770141/P2M/q198608410@ybl/Flipkart,13-05-2023,200,,,23392.15
13-05-2023,UPI/474418795133/P2M/googlepay@axisbank/Zomato,13-05-2023,3225,,,20167.15
13-05-2023,NEFT CR-ICIC0099999-GODREJ AND BOYCE MFG CO LTD-MANDAR SANJAY KADAM-CMS3508162969 G B SALARY CREDIT FOR THE MONTH OF,13-05-2023,279,,,19888.15
14-05-2023,UPI/471226500583/P2M/q198608410@ybl/IRCTC,14-05-2023,,100,,19988.15
14-05-2023,FD THROUGH MOBILE-50355023614693:MANDAR SANJAY KADAM,14-05-2023,200,,,19788.15
14-05-2023,NEFT CR-ICIC0099999-GODREJ AND BOYCE MFG CO LTD-MANDAR SANJAY KADAM-CMS3976968452 G B SALARY CREDIT FOR THE MONTH OF,14-05-2023,805,,,18983.15
15-05-2023,UPI/471243051956/P2M/amazonpaybalanceload@apl/Flipkart,15-05-2023,205,,,18778.15
15-05-2023,NEFT CR-ICIC0099999-GODREJ AND BOYCE MFG CO LTD-MANDAR SANJAY KADAM-CMS3228777356 G B SALARY CREDIT FOR THE MONTH OF,15-05-2023,20,,,18758.15
15-05-2023,NEFT CR-ICIC0099999-GODREJ AND BOYCE MFG CO LTD-MANDAR SANJAY KADAM-CMS3472663766 G B SALARY CREDIT FOR THE MONTH OF,15-05-2023,1000,,,17758.15
16-05-2023,FD THROUGH NET-50336371383432:MANDAR SANJAY KADAM,16-05-2023,35,,,17723.15
17-05-2023,Medical Insurance Premium Payment,17-05-2023,130,,,17593.15
17-05-2023,UPI/477988332064/P2M/googlepay@axisbank/Swiggy,17-05-2023,50,,,17543.15
17-05-2023,UPI/487516755047/P2M/googlepay@axisbank/IRCTC,17-05-2023,16,,,17527.15
17-05-2023,NEFT CR-ICIC0099999-GODREJ AND BOYCE MFG CO LTD-MANDAR SANJAY KADAM-CMS3873389757 G B SALARY CREDIT FOR THE MONTH OF,17-05-2023,110,,,17417.15
17-05-2023,NEFT CR-ICIC0099999-GODREJ AND BOYCE MFG CO LTD-MANDAR SANJAY KADAM-CMS3887437298 G B SALARY CREDIT FOR THE MONTH OF,17-05-2023,180,,,17237.15
18-05-2023,BY SANJAY BAPU KADAM,18-05-2023,,35000,,52237.15
18-05-2023,Phone Recharge - Airtel,18-05-2023,60,,,52177.15
18-05-2023,FD THROUGH NET-50366774598193:MANDAR SANJAY KADAM,18-05-2023,155,,,52022.15
18-05-2023,UPI/453466800769/P2M/q198608410@ybl/Flipkart,18-05-2023,20,,,52002.15
18-05-2023,1239100091233 : Closure Proceeds,18-05-2023,,2000,,54002.15
20-05-2023,UPI/453466800769/P2M/q198608410@ybl/Flipkart,20-05-2023,110,,,53892.15
22-05-2023,NEFT CR-ICIC0099999-GODREJ AND BOYCE MFG CO LTD-MANDAR SANJAY KADAM-CMS3565932590 G B SALARY CREDIT FOR THE MONTH OF,22-05-2023,,2200,,56092.15
22-05-2023,Medical Insurance Premium Payment,22-05-2023,280,,,55812.15
22-05-2023,NEFT CR-ICIC0099999-GODREJ AND BOYCE MFG CO LTD-MANDAR SANJAY KADAM-CMS3976846371 G B SALARY CREDIT FOR THE MONTH OF,22-05-2023,20,,,55792.15
22-05-2023,Mobile Recharge - Vodafone Idea,22-05-2023,,130,,55922.15
22-05-2023,UPI/441521409876/P2M/q198608410@ybl/Swiggy,22-05-2023,50,,,55872.15
23-05-2023,IB FD PREMAT INT PAID-50302470776576,23-05-2023,20,,,55852.15
24-05-2023,FD THROUGH NET-50336371383432:MANDAR SANJAY KADAM,24-05-2023,5,,,55847.15
25-05-2023,UPI/471226500583/P2M/q198608410@ybl/IRCTC,25-05-2023,120,,,55727.15
25-05-2023,UPI/403322158045/P2M/googlepay@axisbank/Amazon,25-05-2023,719,,,55008.15
26-05-2023,FD THROUGH NET-50395039923740:MANDAR SANJAY KADAM,26-05-2023,70,,,54938.15
28-05-2023,POS 314815206131 LOKSEVA PETROLEUM     \,28-05-2023,350,,,54588.15
28-05-2023,UPI/474468662823/P2M/googlepay@axisbank/Flipkart,28-05-2023,68,,,54520.15
28-05-2023,Hospital Bill - MANDAR SANJAY KADAM,28-05-2023,3.52,,,54516.63
28-05-2023,NEFT CR-ICIC0099999-GODREJ AND BOYCE MFG CO LTD-MANDAR SANJAY KADAM-CMS3036192248 G B SALARY CREDIT FOR THE MONTH OF,28-05-2023,1035,,,53481.63
29-05-2023,NEFT CR-ICIC0099999-GODREJ AND BOYCE MFG CO LTD-MANDAR SANJAY KADAM-CMS3695735276 G B SALARY CREDIT FOR THE MONTH OF,29-05-2023,70,,,53411.63
30-05-2023,NEFT CR-ICIC0099999-GODREJ AND BOYCE MFG CO LTD-MANDAR SANJAY KADAM-CMS3055692398 G B SALARY CREDIT FOR THE MONTH OF,30-05-2023,,1000,,54411.63
30-05-2023,NEFT CR-ICIC0099999-GODREJ AND BOYCE MFG CO LTD-MANDAR SANJAY KADAM-CMS3172137111 G B SALARY CREDIT FOR THE MONTH OF,30-05-2023,149.38,,,54262.25
31-05-2023,UPI/351792691423/P2M/q973888055@ybl/SWAMI FOODS,31-05-2023,20,,,54242.25
31-05-2023,NEFT CR-ICIC0099999-MANDAR SANJAY KADAM-CMS3999378791,31-05-2023,35,,,54207.25
01-06-2023,NEFT CR-ICIC0099999-GODREJ AND BOYCE MFG CO LTD-MANDAR SANJAY KADAM-CMS3068454046 G B SALARY CREDIT FOR THE MONTH OF,01-06-2023,,1000,,55207.25
01-06-2023,Amazon Pay Credit - Flipkart,01-06-2023,200,,,55007.25
01-06-2023,NEFT CR-ICIC0099999-MANDAR SANJAY KADAM-CMS3926061397,01-06-2023,105,,,54902.25
02-06-2023,Loan Repayment - HDFC Personal Loan,02-06-2023,340,,,54562.25
02-06-2023,UPI/553301252564/P2M/q765412390@ybl/Subway,02-06-2023,250,,,54312.25
02-06-2023,NEFT CR-ICIC0099999-GODREJ AND BOYCE MFG CO LTD-MANDAR SANJAY KADAM-CMS3873389757 G B SALARY CREDIT FOR THE MONTH OF,02-06-2023,5,,,54307.25
02-06-2023,NEFT CR-ICIC0099999-GODREJ AND BOYCE MFG CO LTD-MANDAR SANJAY KADAM-CMS3940394806 G B SALARY CREDIT FOR THE MONTH OF,02-06-2023,45,,,54262.25
03-06-2023,FD THROUGH MOBILE-50355023614693:MANDAR SANJAY KADAM,03-06-2023,870,,,53392.25
03-06-2023,UPI/470386770141/P2M/q198608410@ybl/Flipkart,03-06-2023,67,,,53325.25
03-06-2023,Medical Insurance Premium Payment - Max Bupa,03-06-2023,20,,,53305.25
04-06-2023,1239010105996:Int.Pd:01-03-2023 to 31-05-2023,04-06-2023,,123,,53428.25
04-06-2023,NEFT_IN:BARBY23156597961/0035/ SANJAY BAPU KADAM,04-06-2023,,9000,,62428.25
04-06-2023,1239010105996 To 123920PPF00000000032,04-06-2023,9000,,,53428.25
05-06-2023,ECOM 315503809383 Paytm_AgodaCompanyPTEL\,05-06-2023,3560.24,,,49868.01
06-06-2023,FD THROUGH NET-50371498812629:MANDAR SANJAY KADAM,06-06-2023,100,,,49768.01
06-06-2023,UPI/495715410571/P2M/amazonpaybalanceload@apl/Indian Oil,06-06-2023,35,,,49733.01
06-06-2023,NEFT CR-HDFC0099999-XYZ COMPANY LTD-ANIRUDH SHARMA-CMS3029876540 MONTHLY PAYROLL,06-06-2023,50,,,49683.01
08-06-2023,NEFT_IN:BARBU23159126257/0042/ SANJAY BAPU KADAM,08-06-2023,,6000,,55683.01
08-06-2023,FD THROUGH NET-50326587608055:MANDAR SANJAY KADAM,08-06-2023,333.9,,,55349.11
08-06-2023,NEFT CR-ICIC0099999-GODREJ AND BOYCE MFG CO LTD-MANDAR SANJAY KADAM-CMS3497137062 G B SALARY CREDIT FOR THE MONTH OF,08-06-2023,120,,,55229.11
09-06-2023,ECOM 316013414351 XBCMFNPS              \,09-06-2023,50000,,,5229.11
09-06-2023,NEFT CR-ICIC0099999-MANDAR SANJAY KADAM-CMS3644333553,09-06-2023,,6,,5235.11
09-06-2023,UPI/352669253115/P2V/manegaurav16@okhdfcbank/GAURA,09-06-2023,180,,,5055.11
09-06-2023,NEFT CR-ICIC0099999-GODREJ AND BOYCE MFG CO LTD-MANDAR SANJAY KADAM-CMS3869924394 G B SALARY CREDIT FOR THE MONTH OF,09-06-2023,181,,,4874.11
10-06-2023,Credit Card EMI Payment - Bajaj Finance,10-06-2023,240,,,4634.11
10-06-2023,UPI/458516593651/P2M/q198608410@ybl/Flipkart,10-06-2023,25,,,4609.11
10-06-2023,FD THROUGH MOBILE-50368759479576:MANDAR SANJAY KADAM,10-06-2023,389,,,4220.11
10-06-2023,UPI/352742897489/P2M/q477479372@ybl/SHESHARAM POON,10-06-2023,40,,,4180.11
12-06-2023,NEFT CR-ICIC0099999-GODREJ AND BOYCE MFG CO LTD-MANDAR SANJAY KADAM-CMS3520890650 G B SALARY CREDIT FOR THE MONTH OF,12-06-2023,,3000,,7180.11
12-06-2023,UPI/538301353333/P2M/bookmyshow289710.rzp@rxairte/BookMyShow,12-06-2023,100,,,7080.11
12-06-2023,UPI/471243051956/P2M/amazonpaybalanceload@apl/Flipkart,12-06-2023,60,,,7020.11
12-06-2023,NEFT CR-ICIC0099999-GODREJ AND BOYCE MFG CO LTD-MANDAR SANJAY KADAM-CMS3851194819 G B SALARY CREDIT FOR THE MONTH OF,12-06-2023,200,,,6820.11
13-06-2023,NEFT CR-ICIC0099999-GODREJ AND BOYCE MFG CO LTD-MANDAR SANJAY KADAM-CMS3311285081 G B SALARY CREDIT FOR THE MONTH OF,13-06-2023,,55,,6875.11
13-06-2023,NEFT CR-ICIC0099999-GODREJ AND BOYCE MFG CO LTD-MANDAR SANJAY KADAM-CMS3228777356 G B SALARY CREDIT FOR THE MONTH OF,13-06-2023,106,,,6769.11
14-06-2023,UPI/484917246437/P2M/q198608410@ybl/Amazon,14-06-2023,255,,,6514.11
15-06-2023,UPI/431794200909/P2M/amazonpaybalanceload@apl/Myntra,15-06-2023,,70,,6584.11
15-06-2023,UPI/464028838086/P2M/googlepay@axisbank/Flipkart,15-06-2023,140,,,6444.11
16-06-2023,NEFT CR-ICIC0099999-MANDAR SANJAY KADAM-CMS3276009408,16-06-2023,40,,,6404.11
16-06-2023,NEFT CR-ICIC0099999-GODREJ AND BOYCE MFG CO LTD-MANDAR SANJAY KADAM-CMS3343559776 G B SALARY CREDIT FOR THE MONTH OF,16-06-2023,250,,,6154.11
20-06-2023,UPI/474418795133/P2M/googlepay@axisbank/Zomato,20-06-2023,30,,,6124.11
20-06-2023,NEFT CR-ICIC0099999-MANDAR SANJAY KADAM-CMS3953431365,20-06-2023,15,,,6109.11
20-06-2023,NEFT CR-ICIC0099999-GODREJ AND BOYCE MFG CO LTD-MANDAR SANJAY KADAM-CMS3024042348 G B SALARY CREDIT FOR THE MONTH OF,20-06-2023,30,,,6079.11
20-06-2023,NEFT CR-ICIC0099999-GODREJ AND BOYCE MFG CO LTD-MANDAR SANJAY KADAM-CMS3549474702 G B SALARY CREDIT FOR THE MONTH OF,20-06-2023,60,,,6019.11
20-06-2023,NEFT CR-ICIC0099999-GODREJ AND BOYCE MFG CO LTD-MANDAR SANJAY KADAM-CMS3486235810 G B SALARY CREDIT FOR THE MONTH OF,20-06-2023,80,,,5939.11
20-06-2023,NEFT CR-SBI0097777-INFOSYS TECHNOLOGIES LTD-AMIT PANDEY-CMS4567893210 QUARTERLY BONUS,20-06-2023,136,,,5803.11
21-06-2023,CREDIT INTEREST CAPITALISED,21-06-2023,40,,,5763.11
21-06-2023,IB FD PREMAT INT PAID-50308648829057,21-06-2023,70,,,5693.11
22-06-2023,UPI/487516755047/P2M/googlepay@axisbank/IRCTC,22-06-2023,90,,,5603.11
22-06-2023,NEFT CR-ICIC0099999-GODREJ AND BOYCE MFG CO LTD-MANDAR SANJAY KADAM-CMS3513962730 G B SALARY CREDIT FOR THE MONTH OF,22-06-2023,60,,,5543.11
23-06-2023,UPI/457764899862/P2M/q198608410@ybl/IRCTC,23-06-2023,,160,,5703.11
23-06-2023,Electricity Bill Payment,23-06-2023,10,,,5693.11
23-06-2023,NEFT CR-ICIC0099999-GODREJ AND BOYCE MFG CO LTD-MANDAR SANJAY KADAM-CMS3472663766 G B SALARY CREDIT FOR THE MONTH OF,23-06-2023,150,,,5543.11
24-06-2023,NEFT CR-ICIC0099999-GODREJ AND BOYCE MFG CO LTD-MANDAR SANJAY KADAM-CMS3686284545 G B SALARY CREDIT FOR THE MONTH OF,24-06-2023,10,,,5533.11
24-06-2023,Internet Bill Payment - Airtel XStream,24-06-2023,80,,,5453.11
24-06-2023,UPI/458468630745/P2M/googlepay@axisbank/IRCTC,24-06-2023,319,,,5134.11
24-06-2023,UPI/523641892839/P2M/q108764291@ybl/McDonalds,24-06-2023,10,,,5124.11
25-06-2023,UPI/354218338970/P2M/8275072999@okbizaxis/Hotel Sh,25-06-2023,2500,,,2624.11
25-06-2023,NEFT CR-ICIC0099999-GODREJ AND BOYCE MFG CO LTD-MANDAR SANJAY KADAM-CMS3508162969 G B SALARY CREDIT FOR THE MONTH OF,25-06-2023,130,,,2494.11
25-06-2023,NEFT CR-ICICI0098888-KOTAK SECURITIES-ROHIT MALIK-CMS4123985612 MUTUAL FUND DIVIDEND,25-06-2023,200,,,2294.11
26-06-2023,NEFT_IN:BARBS23177448553/0027/ SANJAY BAPU KADAM,26-06-2023,,10000,,12294.11
26-06-2023,Toll Payment - FASTag NHAI,26-06-2023,300,,,11994.11
26-06-2023,UPI/467664603056/P2M/googlepay@axisbank/Myntra,26-06-2023,460,,,11534.11
26-06-2023,CREDIT INTEREST CAPITALISED - QUARTERLY PAYOUT,26-06-2023,320,,,11214.11
26-06-2023,NEFT CR-ICIC0099999-GODREJ AND BOYCE MFG CO LTD-MANDAR SANJAY KADAM-CMS3641645486 G B SALARY CREDIT FOR THE MONTH OF,26-06-2023,1790,,,9424.11
27-06-2023,UPI/477988332064/P2M/googlepay@axisbank/Swiggy,27-06-2023,72,,,9352.11
28-06-2023,IB FD PREMAT PRINCIPAL-50355096688727,28-06-2023,,120,,9472.11
28-06-2023,UPI/464616072856/P2M/googlepay@axisbank/IRCTC,28-06-2023,60,,,9412.11
28-06-2023,UPI/497171245639/P2M/amazonpaybalanceload@apl/Indian Oil,28-06-2023,839,,,8573.11
28-06-2023,NEFT CR-ICIC0099999-GODREJ AND BOYCE MFG CO LTD-MANDAR SANJAY KADAM-CMS3976968452 G B SALARY CREDIT FOR THE MONTH OF,28-06-2023,232,,,8341.11
29-06-2023,UPI/318008154671/P2M/bharatpe.9041938120@icici/Bha,29-06-2023,250,,,8091.11
29-06-2023,UPI/318023864247/P2M/Q46389161@ybl/BP Petrol Pump,29-06-2023,250,,,7841.11
30-06-2023,UPI/354755978465/P2M/q103368532@ybl/Master RAVINDR,30-06-2023,60,,,7781.11
05-07-2023,POS 318615774550 Bhosale Cng Pump      \,05-07-2023,784.32,,,6996.79
06-07-2023,NEFT_IN:BARBV23187806846/0017/ SANJAY BAPU KADAM,06-07-2023,,2000,,8996.79
06-07-2023,POS 318712214395 MODERN AUTOMOBILES    \,06-07-2023,315,,,8681.79
06-07-2023,UPI/318704287117/P2M/gpay-11198241861@okbizaxis/Va,06-07-2023,100,,,8581.79
06-07-2023,UPI/318746070688/P2M/gpay-11198241861@okbizaxis/Va,06-07-2023,55,,,8526.79
06-07-2023,UPI/355366985890/P2M/paytmqr13r3my9mze@paytm/DINES,06-07-2023,90,,,8436.79
07-07-2023,UPI/355421214138/P2M/q17657005@ybl/Lokmanya Hospit,07-07-2023,4000,,,4436.79
08-07-2023,POS 318912366366 WELLNESS FOREVER      \,08-07-2023,389.34,,,4047.45
08-07-2023,UPI/355584240768/P2M/q444557204@ybl/SANJAY FOODS,08-07-2023,45,,,4002.45
11-07-2023,UPI/319238447404/P2M/bharatpe.90064181702@fbpe/MAD,11-07-2023,60,,,3942.45
11-07-2023,VPET/Y04/214395/46248812390301,11-07-2023,1.49,,,3940.96
12-07-2023,UPI/319367872188/P2V/rajeshsurya9007@okhdfcbank/RA,12-07-2023,3300,,,640.96
13-07-2023,UPI/319492790855/P2V/rajeshsurya9007@okhdfcbank/RA,13-07-2023,,105,,745.96
14-07-2023,UPI/319575150002/P2M/q901567052@ybl/BHARAT SWEETS,14-07-2023,75,,,670.96
16-07-2023,SMS CHRG FOR:01-04-2023to30-06-2023,16-07-2023,17.7,,,653.26
20-07-2023,UPI/356739961258/P2V/rajeshsurya9007@okhdfcbank/RA,20-07-2023,156.25,,,497.01
21-07-2023,UPI/356809392545/P2M/bharatpe.9100431679@icici/Bha,21-07-2023,10,,,487.01
22-07-2023,UPI/320318339407/P2M/paytmqrp6wzgsnu1d@paytm/NARAY,22-07-2023,10,,,477.01
26-07-2023,UPI/320774923086/P2V/goog-payment@okaxis/GOOGLEPAY,26-07-2023,,6,,483.01
26-07-2023,NEFT_IN:BARBR23207380526/0044/ SANJAY BAPU KADAM,26-07-2023,,10000,,10483.01
28-07-2023,UPI/320977582408/P2M/paytmqr6kvohjbszr@paytm/DEELI,28-07-2023,30,,,10453.01
29-07-2023,UPI/321010304805/P2V/goog-payment@okaxis/GOOGLEPAY,29-07-2023,,6,,10459.01
29-07-2023,UPI/321004360114/P2V/santoshsantosh40920@okicici/M,29-07-2023,100,,,10359.01
30-07-2023,UPI/321121244171/P2M/gpay-11235053503@okbizaxis/Do,30-07-2023,70,,,10289.01
06-08-2023,NEFT_IN:BARBW23219620945/0028/ SANJAY BAPU KADAM,06-08-2023,,10000,,20289.01
06-08-2023,UPI/321831047372/P2M/gpay-11214228733@okbizaxis/HO,06-08-2023,120,,,20169.01
10-08-2023,UPI/322252848188/P2V/9730132052@paytm/PaytmUser,10-08-2023,215,,,19954.01
11-08-2023,UPI/322390386780/P2M/gpay-11214228733@okbizaxis/HO,11-08-2023,36,,,19918.01
12-08-2023,UPI/322403384158/P2M/bharatpe.9100431679@icici/Bha,12-08-2023,10,,,19908.01
13-08-2023,POS 322510661592 HOTEL SHIVRAJ         \,13-08-2023,1596,,,18312.01
14-08-2023,UPI/322679893907/P2M/paytmqrz2n29htd7x@paytm/POL S,14-08-2023,130,,,18182.01
16-08-2023,NEFT SANJAY BAPU KADAM,16-08-2023,,5000,,23182.01
17-08-2023,UPI/322964375121/P2V/rajeshsurya9007@okhdfcbank/RA,17-08-2023,3078.66,,,20103.35
19-08-2023,UPI/323109326971/P2M/amazonupi@apl/AMAZONPA,19-08-2023,100,,,20003.35
20-08-2023,NEFT_IN:BARBT23233556697/0020/ SANJAY BAPU KADAM,20-08-2023,,10000,,30003.35
22-08-2023,NEFT_IN:BARBW23234693336/0044/ SANJAY BAPU KADAM,22-08-2023,,10000,,40003.35
24-08-2023,IMPS-IN/323607556002/6364859977/Cashfree,24-08-2023,,1,,40004.35
26-08-2023,UPI/323821281112/P2M/paytmqrpeywrjdkf1@paytm/SHANK,26-08-2023,63,,,39941.35
02-09-2023,1239010105996:Int.Pd:01-06-2023 to 31-08-2023,02-09-2023,,76,,40017.35
02-09-2023,UPI/324533862324/P2M/paytmqryqq1j56qdm@paytm/NARAY,02-09-2023,70,,,39947.35
05-09-2023,UPI/324823839280/P2V/goog-payment@okaxis/GOOGLEPAY,05-09-2023,,11,,39958.35
05-09-2023,NEFT_IN:BARBU23248027505/0025/ SANJAY BAPU KADAM,05-09-2023,,10000,,49958.35
05-09-2023,UPI/361434001663/P2M/amazonpayhfc@apl/Amazon Pay,05-09-2023,609,,,49349.35
06-09-2023,UPI/324961222848/P2V/manegaurav16@okhdfcbank/GAURA,06-09-2023,215.58,,,49133.77
11-09-2023,UPI/325499599802/P2M/cca.2714597@icici/INDIAN INST,11-09-2023,3600,,,45533.77
13-09-2023,UPI/325664291857/P2M/zomato-order@paytm/Zomato Ltd,13-09-2023,984.65,,,44549.12
25-09-2023,UPI/326832160758/P2M/paytmqr1elfnp9skw@paytm/Cloth,25-09-2023,170,,,44379.12
30-09-2023,IMPS-IN/327319817253/9421010634/AJAY ASH,30-09-2023,,8000,,52379.12
03-10-2023,UPI/364276192717/P2M/amazonupi@apl/Axis,03-10-2023,100,,,52279.12
04-10-2023,UPI/364377867056/P2M/amazonupi@apl/Axis,04-10-2023,70,,,52209.12
07-10-2023,UPI/328034228005/P2M/paytmqrqn2rl6yzt2@paytm/HOLKA,07-10-2023,40,,,52169.12
08-10-2023,NEFT_IN:BARBZ23282579501/0038/ SANJAY BAPU KADAM,08-10-2023,,10000,,62169.12
08-10-2023,UPI/364711771391/P2M/amazonpayhfc@yapl/Amazon Pay,08-10-2023,140,,,62029.12
08-10-2023,UPI/364718045041/P2M/amazonpayhfc@yapl/Amazon Pay,08-10-2023,250,,,61779.12
09-10-2023,UPI/328256849225/P2V/goog-payment@okaxis/GOOGLEPAY,09-10-2023,,4,,61783.12
12-10-2023,IMPS-IN/328520695381/9960152365/SANJAYBA,12-10-2023,,5300,,67083.12
12-10-2023,UPI/365170130559/P2M/amazonpayhfc@apl/Amazon Pay,12-10-2023,1150,,,65933.12
12-10-2023,UPI/365198940302/P2M/amazonpayhfc@apl/Amazon Pay,12-10-2023,1129,,,64804.12
12-10-2023,NEFT_IN:BARBV23285979352/0037/ SANJAY BAPU KADAM,12-10-2023,,5000,,69804.12
15-10-2023,UPI/328808227505/P2M/q264481496@ybl/ANNAPURANA MES,15-10-2023,48,,,69756.12
15-10-2023,UPI/328828685497/P2M/q249295619@ybl/ANNAPURANA MES,15-10-2023,40,,,69716.12
18-10-2023,NEFT_IN:BARBU23291778245/0043/ SANJAY BAPU KADAM,18-10-2023,,5000,,74716.12
18-10-2023,UPI/329125776016/P2M/paytmqrs2jk71jpnr@paytm/Maste,18-10-2023,60,,,74656.12
18-10-2023,UPI/329134454857/P2V/atulkoli0412-1@okhdfcbank/ATU,18-10-2023,2400,,,72256.12
19-10-2023,SMS CHRG FOR:01-07-2023to30-09-2023,19-10-2023,17.7,,,72238.42
21-10-2023,IMPS-IN/329410735130/6364888137/Rentomoj,21-10-2023,,229,,72467.42
21-10-2023,UPI/329428549749/P2M/9623320662@okbizaxis/BHARAT T,21-10-2023,340,,,72127.42
21-10-2023,UPI/329429108410/P2M/9623320662@okbizaxis/BHARAT T,21-10-2023,10,,,72117.42
24-10-2023,ATM WDR 7179 PNB \JEWEL MOF PIMPRI KAMLA   \ PUNE,24-10-2023,500,,,71617.42
02-11-2023,UPI/330620607014/P2M/q006536458@ybl/HP Petrol Pump,02-11-2023,250,,,71367.42
04-11-2023,UPI/330894579085/P2M/paytmqrs2jk71jpnr@paytm/Maste,04-11-2023,60,,,71307.42
08-11-2023,UPI/367819143226/P2M/amazonpayhfc@apl/Amazon Pay,08-11-2023,390,,,70917.42
09-11-2023,UPI/331353914132/P2V/shankarpawar47@okhdfcbank/SHA,09-11-2023,160,,,70757.42
10-11-2023,B01/BARBX23312847655      /NEF,10-11-2023,,10000,,80757.42
11-11-2023,UPI/331542833379/P2M/paytmqrs2jk71jpnr@paytm/Maste,11-11-2023,60,,,80697.42
12-11-2023,UPI/331563989821/P2M/itsonline@ybl/INFINITY TRANSO,12-11-2023,540,,,80157.42
13-11-2023,UPI/331700621149/P2V/u47316934@axl/SANJAY RAGHUNAT,13-11-2023,50,,,80107.42
15-11-2023,UPI/331927103671/P2M/amazonpayhfc@apl/Amazon Pay,15-11-2023,990,,,79117.42
21-11-2023,UPI/332531461110/P2V/goog-payment@okaxis/GOOGLEPAY,21-11-2023,,3,,79120.42
27-11-2023,UPI/333172976441/P2M/q458391246@ybl/HP Petrol Pump,27-11-2023,220,,,78900.42
01-12-2023,UPI/333533050990/P2M/q601744316@ybl/HOTEL SAVERA,01-12-2023,50,,,78850.42
03-12-2023,1239010105996:Int.Pd:01-09-2023 to 30-11-2023,03-12-2023,,42,,78892.42
06-12-2023,NEFT_IN:BARBW23340450853/0021/ SANJAY BAPU KADAM,06-12-2023,,10000,,88892.42
06-12-2023,UPI/334049568576/P2M/amazonpayhfc@apl/Amazon Pay,06-12-2023,530,,,88362.42
06-12-2023,UPI/370675618314/P2M/amazonpayhfc@apl/Amazon Pay,06-12-2023,140,,,88222.42
07-12-2023,UPI/334145586651/P2M/q642279439@ybl/HP Petrol Pump,07-12-2023,300,,,87922.42
07-12-2023,UPI/334154162945/P2V/santoshsantosh40920@okicici/M,07-12-2023,1000,,,86922.42
10-12-2023,UPI/334444446883/P2M/q487507788@ybl/HOTEL SAVERA,10-12-2023,210,,,86712.42
15-12-2023,UPI/334937177775/P2M/billdesk.piped-gas@icici/bill,15-12-2023,1385,,,85327.42
20-12-2023,UPI/335415598959/P2M/amazonupi@apl/Axis,20-12-2023,300,,,85027.42
22-12-2023,UPI/335686134201/P2M/paytmqr1dibidraep@paytm/GUNDA,22-12-2023,30,,,84997.42
02-01-2024,NEFT_IN:BARBT24002693438/0047/ SANJAY BAPU KADAM,02-01-2024,,10000,,94997.42
14-01-2024,SMS CHRG FOR:01-10-2023to31-12-2023,14-01-2024,17.7,,,94979.72
23-01-2024,NEFT_IN:BARBU24023157593/0027/ SANJAY BAPU KADAM,23-01-2024,,10000,,104979.72
23-01-2024,UPI/402343263363/P2M/gpay-11203583676@okbizaxis/TR,23-01-2024,35,,,104944.72
01-02-2024,UPI/403257266451/P2M/amazonpayhfc@apl/Amazon Pay,01-02-2024,720,,,104224.72
03-02-2024,UPI/403437375073/P2M/paytmqrqu5xuir4tz@paytm/HARIO,03-02-2024,40,,,104184.72
04-02-2024,UPI/403509383174/P2M/bharatpe.90063413300@fbpe/Amo,04-02-2024,100,,,104084.72
16-02-2024,UPI/404752217562/P2M/gpaybillpay.gas11@okpayaxis/G,16-02-2024,1437,,,102647.72
17-02-2024,NEFT_IN:BARBT24048136826/0038/ SANJAY BAPU KADAM,17-02-2024,,10000,,112647.72
18-02-2024,UPI/404981252515/P2M/swdbitspilani.payu@axisbank/s,18-02-2024,3300,,,109347.72
20-02-2024,UPI/405184772300/P2M/gpay-11239537756@okbizaxis/Ba,20-02-2024,30,,,109317.72
21-02-2024,UPI-REV/405221080730/P2M/bharatpe.90066465074@fbpe,21-02-2024,,330,,109647.72
21-02-2024,UPI/405225559766/P2M/paytmqr1owogiv6w1@paytm/Cloth,21-02-2024,80,,,109567.72
23-02-2024,UPI/405489851113/P2M/q689976099@ybl/MASTER PRATIK,23-02-2024,180,,,109387.72
24-02-2024,UPI/405528145802/P2M/q820504173@ybl/HP Petrol Pump,24-02-2024,350,,,109037.72
26-02-2024,UPI/442347351088/P2V/rushisomwanshi8207-1@okaxis/R,26-02-2024,,500,,109537.72
27-02-2024,UPI/405827548794/P2M/amazonpayhfc@apl/Amazon Pay,27-02-2024,740,,,108797.72
27-02-2024,UPI/405844872354/P2M/amazonpayhfc@apl/Amazon Pay,27-02-2024,220,,,108577.72
27-02-2024,UPI/405877367859/P2M/amazonpayhfc@apl/Amazon Pay,27-02-2024,238,,,108339.72
01-03-2024,UPI/406142653663/P2M/gpay-11240417409@okbizaxis/Ch,01-03-2024,70,,,108269.72
03-03-2024,UPI/406306290827/P2M/paytmqra1f1luvfbd@paytm/REAL,03-03-2024,35,,,108234.72
04-03-2024,1239010105996:Int.Pd:01-12-2023 to 29-02-2024,04-03-2024,,52,,108286.72
06-03-2024,ECOM 406505858402 Amazon Pay India pvt l\,06-03-2024,715,,,107571.72
09-03-2024,UPI/406924758267/P2M/q220779525@ybl/TRISHA FOODS A,09-03-2024,40,,,107531.72
12-03-2024,BY CASH,12-03-2024,,5000,,112531.72
14-03-2024,UPI/407474413349/P2M/amazonpaybalanceload@apl/Amaz,14-03-2024,2535,,,109996.72
20-03-2024,NEFT_IN:BARBX24080009847/0022/ SANJAY BAPU KADAM,20-03-2024,,10000,,119996.72
21-03-2024,UPI/408102213587/P2M/amazonpayhfc@apl/Amazon Pay,21-03-2024,270,,,119726.72
21-03-2024,UPI/408184657304/P2M/amazonupi@apl/Axis,21-03-2024,100,,,119626.72
21-03-2024,UPI/444785387190/P2M/amazonpayhfc@apl/Amazon Pay,21-03-2024,880,,,118746.72
23-03-2024,UPI/444910225362/P2M/amazonupi@apl/Axis,23-03-2024,500,,,118246.72
25-03-2024,UPI/408590452507/P2M/amazonupi@apl/Axis,25-03-2024,150,,,118096.72
27-03-2024,UPI/445383846425/P2M/amazonpaybalanceload@apl/Amaz,27-03-2024,2400,,,115696.72
31-03-2024,IMPS-IN/409223552976/9960152365/SANJAYBA,31-03-2024,,5000,,120696.72
31-03-2024,ECOM 409209495282 IITMADRAS             \,31-03-2024,1000,,,119696.72
31-03-2024,ECOM 409210593166 IITMADRAS             \,31-03-2024,1000,,,118696.72
31-03-2024,UPI/409279139660/P2M/amazonpaybalanceload@apl/Amaz,31-03-2024,280,,,118416.72
31-03-2024,UPI/445834998227/P2M/amazonpaybalanceload@apl/Amaz,31-03-2024,500,,,117916.72
02-04-2024,NEFT SANJAY BAPU KADAM,02-04-2024,,10000,,127916.72
02-04-2024,UPI/445982870267/P2M/amazonpaybalanceload@apl/Amaz,02-04-2024,1500,,,126416.72
03-04-2024,NEFT_IN:BARBP24094362458/0019/ SANJAY BAPU KADAM,03-04-2024,,1000,,127416.72
03-04-2024,ECOM 409413463201 PAY*BREVISTAY HOSPITAL\,03-04-2024,2999,,,124417.72
03-04-2024,UPI/409401975522/P2M/paytmqr1wio97z6ot@paytm/AKSHA,03-04-2024,25,,,124392.72
03-04-2024,UPI/446182974833/P2M/amazonpaybalanceload@apl/Amaz,03-04-2024,2450,,,121942.72
04-04-2024,UPI-REV/409518283114/P2M/919422584174.a@mahb/MANDA,04-04-2024,,1,,121943.72
04-04-2024,NEFT_IN:BARBR24095631013/0024/ SANJAY BAPU KADAM,04-04-2024,,2000,,123943.72
05-04-2024,UPI/409678879898/P2M/paytmqrvhe2ctlq6l@paytm/SAHBA,05-04-2024,200,,,123743.72
05-04-2024,UPI/446387130367/P2M/sbiepay.iitk-1002016@sbi/Indi,05-04-2024,500,,,123243.72
06-04-2024,POS 409714928706 TCI INDIA LIMITED     \,06-04-2024,200,,,123043.72
07-04-2024,SMS CHRG FOR:01-01-2024to31-03-2024,07-04-2024,17.7,,,123026.02
08-04-2024,VREF/W01/463201/43570860139617,08-04-2024,,2999,,126025.02
08-04-2024,ECOM 410001463396 Indian Institute of Te\,08-04-2024,500,,,125525.02
08-04-2024,UPI/409916574678/P2M/q564302048@ybl/HOTEL SHREE FA,08-04-2024,105,,,125420.02
09-04-2024,UPI/410026390663/P2M/nta.bdpg@icici/National Testi,09-04-2024,750,,,124670.02
09-04-2024,UPI/410061365883/P2M/sbiepay.iitismd-1000905@sbi/I,09-04-2024,1800,,,122870.02
10-04-2024,UPI/410171264102/P2M/iitgandhinagar.bdpg@icici/Ind,10-04-2024,300,,,122570.02
10-04-2024,UPI/410181029722/P2M/sbiepay.iitk-1002016@sbi/Indi,10-04-2024,500,,,122070.02
10-04-2024,UPI/410196752134/P2M/sbiepay.iitk-1002016@sbi/Indi,10-04-2024,500,,,121570.02
11-04-2024,IMPS-IN/410211920548/9960152365/SANJAYBA,11-04-2024,,1300,,122870.02
11-04-2024,UPI/410270386542/P2M/irctc.cf@hdfcbank/IRCTC CF,11-04-2024,3403.6,,,119466.42
12-04-2024,BY CASH,12-04-2024,,20000,,139466.42
12-04-2024,UPI/410353943454/P2M/q482768401@ybl/HOTEL LOKPRIYA,12-04-2024,70,,,139396.42
12-04-2024,UPI/410372109306/P2M/irctc.cf@hdfcbank/IRCTC CF,12-04-2024,5963.6,,,133432.82
12-04-2024,UPI/410372358663/P2M/irctc.cf@hdfcbank/IRCTC CF,12-04-2024,4843.6,,,128589.22
12-04-2024,UPI/410373875027/P2M/irctc.cf@hdfcbank/IRCTC CF,12-04-2024,521.8,,,128067.42
13-04-2024,UPI/410475603235/P2A/9968956987/IRCTC CF,13-04-2024,,3250,,131317.42
13-04-2024,UPI/447028987048/P2M/amazonpaybalanceload@yapl/Ama,13-04-2024,170,,,131147.42
14-04-2024,UPI/410419343809/P2V/neelkamalhotel1@okaxis/HOTEL,14-04-2024,310,,,130837.42
17-04-2024,NEFT_IN:BARBU24108593976/0030/ SANJAY BAPU KADAM,17-04-2024,,5000,,135837.42
17-04-2024,UPI/410854317047/P2M/q482768401@ybl/HOTEL LOKPRIYA,17-04-2024,50,,,135787.42
18-04-2024,NEFT_IN:BARBV24109798200/0023/ SANJAY BAPU KADAM,18-04-2024,,5000,,140787.42
18-04-2024,ECOM 410914849339 INTERGLOBE AVIATION   \,18-04-2024,9906,,,130881.42
18-04-2024,UPI/410917661332/P2M/iiti.payu@indus/INDIAN INSTIT,18-04-2024,800,,,130081.42
18-04-2024,UPI/410990182383/P2M/irctc.cf@hdfcbank/IRCTC CF,18-04-2024,3863.6,,,126217.82
19-04-2024,ECOM 411019338866 IITMADRAS             \,19-04-2024,610,,,125607.82
19-04-2024,UPI/411036148244/P2M/paytmqr1h4jf8plag@paytm/APPLE,19-04-2024,10,,,125597.82
20-04-2024,POS 411114633271 ARMED FORCES EX OFFICE\,20-04-2024,604.54,,,124993.28
20-04-2024,UPI/411188972540/P2M/q482768401@ybl/HOTEL LOKPRIYA,20-04-2024,50,,,124943.28
23-04-2024,UPI/411400585981/P2M/irctcpov.rzp@mairtel/irctc,23-04-2024,696,,,124247.28
25-04-2024,UPI/411611852811/P2A/9968956987/IRCTC CF,25-04-2024,,5810,,130057.28
25-04-2024,UPI/411653189922/P2M/q216791088@ybl/SHREE XEROX AN,25-04-2024,136,,,129921.28
25-04-2024,UPI/411654196682/P2M/q482768401@ybl/HOTEL LOKPRIYA,25-04-2024,70,,,129851.28
26-04-2024,UPI/411780120641/P2M/amazonpaybalanceload@rapl/Ama,26-04-2024,1000,,,128851.28
26-04-2024,UPI/411794199177/P2M/amznlpa-df7xzkhnbz@yapl/IRCTC,26-04-2024,192.7,,,128658.58
29-04-2024,UPI/412023187947/P2A/9968956987/IRCTC CF,29-04-2024,,390,,129048.58
30-04-2024,UPI/412166494743/P2M/q482768401@ybl/HOTEL LOKPRIYA,30-04-2024,70,,,128978.58
01-05-2024,NEFT_IN:BARBW24122884287/0041/ SANJAY BAPU KADAM,01-05-2024,,10000,,138978.58
01-05-2024,UPI/412206887055/P2M/vrlonline@ybl/VIJAYANAND TRAV,01-05-2024,5356,,,133622.58
01-05-2024,UPI/412207600005/P2M/vrlonline@ybl/VIJAYANAND TRAV,01-05-2024,3928,,,129694.58
05-05-2024,UPI/412638290896/P2V/u47316934@axl/SANJAY RAGHUNAT,05-05-2024,50,,,129644.58
06-05-2024,UPI/412791027288/P2M/q482768401@ybl/HOTEL LOKPRIYA,06-05-2024,50,,,129594.58
10-05-2024,UPI/413100797521/P2V/phonepemerchant@yesbank/Phone,10-05-2024,,2887.33,,132481.91
10-05-2024,UPI/413175938200/P2M/q220779525@ybl/TRISHA FOODS A,10-05-2024,20,,,132461.91
10-05-2024,UPI/413176965675/P2M/q509775932@ybl/HOTEL LOKPRIYA,10-05-2024,60,,,132401.91
10-05-2024,UPI/413100794419/P2V/phonepemerchant@yesbank/Phone,10-05-2024,,3936.91,,136338.82
11-05-2024,UPI/413214736960/P2M/q550476715@ybl/M G KUMAVAT,11-05-2024,275,,,136063.82
11-05-2024,UPI/413296941035/P2M/q509775932@ybl/HOTEL LOKPRIYA,11-05-2024,50,,,136013.82
12-05-2024,UPI/413346811195/P2M/gpay-11216702154@okbizaxis/Sh,12-05-2024,2600,,,133413.82
19-05-2024,UPI/414009399302/P2M/q564302048@ybl/HOTEL SHREE FA,19-05-2024,60,,,133353.82
19-05-2024,UPI/414085045374/P2M/amazonpayhfc@yapl/Amazon Pay,19-05-2024,480,,,132873.82
19-05-2024,UPI/414096034675/P2M/amazonpayhfc@rapl/Amazon Pay,19-05-2024,1950,,,130923.82
19-05-2024,UPI/450607706338/P2M/amazonpayhfc@yapl/Amazon Pay,19-05-2024,270,,,130653.82
24-05-2024,NEFT_IN:BARBW24145391062/0038/ SANJAY BAPU KADAM,24-05-2024,,1500,,132153.82
24-05-2024,NEFT_IN:BARBW24145635671/0044/ SANJAY BAPU KADAM,24-05-2024,,5000,,137153.82
25-05-2024,UPI/414654444915/P2M/q821648349@ybl/M G KUMAVAT,25-05-2024,55,,,137098.82
28-05-2024,payu/19999470795/0531895519/Bill Payment,28-05-2024,719,,,136379.82
29-05-2024,payu/20007514682/0532200237/Bill Payment,29-05-2024,51500,,,84879.82
29-05-2024,UPI/415001407609/P2V/sachinbikeclinic-2@okicici/SA,29-05-2024,2650,,,82229.82
30-05-2024,UPI/451719920018/P2M/amazon@rapl/Amazon India,30-05-2024,500,,,81729.82
02-06-2024,1239010105996:Int.Pd:01-03-2024 to 31-05-2024,02-06-2024,,113,,81842.82
03-06-2024,UPI/415595588010/P2M/gpay-11238819265@okbizaxis/Ho,03-06-2024,1000,,,80842.82
03-06-2024,UPI/452165710167/P2M/amazon@rapl/Amazon India,03-06-2024,200,,,80642.82
04-06-2024,NEFT_IN:BARBU24156091713/0038/ SANJAY BAPU KADAM,04-06-2024,,7000,,87642.82
04-06-2024,UPI/415653187866/P2M/q216791088@ybl/SHREE XEROX AN,04-06-2024,63,,,87579.82
05-06-2024,UPI/415761615225/P2M/917875172127   punemetroc/adr,05-06-2024,27,,,87552.82
06-06-2024,UPI/415801944455/P2M/917875172127   punemetroc/adr,06-06-2024,27,,,87525.82
06-06-2024,UPI/415814230675/P2M/917875172127   punemetroc/adr,06-06-2024,27,,,87498.82
06-06-2024,UPI/415816742707/P2V/917875172127   7875172127/ama,06-06-2024,306,,,87192.82
06-06-2024,UPI/452477222694/P2M/917875172127   amazonpayb/lan,06-06-2024,500,,,86692.82
09-06-2024,UPI/416113398644/P2M/917875172127   cca.405@ic/ci,09-06-2024,2329.6,,,84363.22
09-06-2024,UPI/416148357202/P2M/917875172127   paytmqr1bw/tsu,09-06-2024,20,,,84343.22
09-06-2024,UPI/416149301409/P2M/917875172127   paytmqr1bw/tsu,09-06-2024,20,,,84323.22
09-06-2024,UPI/416158809283/P2M/917875172127   fcbizsrivu/@fr,09-06-2024,1097,,,83226.22
10-06-2024,UPI/416281715813/P2M/917875172127   amazonsell/rse,10-06-2024,499,,,82727.22
10-06-2024,1239010105996 To 123920PPF00000000032,10-06-2024,5000,,,77727.22
11-06-2024,UPI/416309770022/P2V/917875172127   kamalsingh/hak,11-06-2024,835,,,76892.22
13-06-2024,NEFT_IN:BARBZ24165968394/0023/ SANJAY BAPU KADAM,13-06-2024,,1500,,78392.22
13-06-2024,UPI/416594338633/P2M/917875172127   kisankonne/tsa,13-06-2024,350,,,78042.22
15-06-2024,ECOM 416706925496 IND*MSEDCL            \,15-06-2024,1866,,,76176.22
18-06-2024,UPI/417021838371/P2M/917875172127   paytmqrg6z/rs0,18-06-2024,28,,,76148.22
19-06-2024,UPI/417155353141/P2M/917875172127   paytmqr122/ces,19-06-2024,176,,,75972.22
21-06-2024,UPI/417362740617/P2A//pepaymentpvtltd@iciciIRCTC E,21-06-2024,,2710,,78682.22
23-06-2024,UPI/417502633019/P2M/917875172127   netflixupi/pay,23-06-2024,199,,,78483.22
25-06-2024,NEFT_IN:BARBZ24177764334/0044/ SANJAY BAPU KADAM,25-06-2024,,7500,,85983.22
25-06-2024,UPI/417784273832/P2M/917875172127   q99669023@/bl,25-06-2024,135,,,85848.22
27-06-2024,BY CASH,27-06-2024,,4700,,90548.22
27-06-2024,UPI/417945699323/P2M/917875172127   punemetroc/adr,27-06-2024,27,,,90521.22
27-06-2024,UPI/417961349243/P2M/917875172127   punemetroc/adr,27-06-2024,54,,,90467.22
28-06-2024,UPI/418001041697/P2M/917875172127   vrlonline@/bl,28-06-2024,2856,,,87611.22
28-06-2024,UPI/418066309185/P2V/911079651932   pg.razorpa/@ax,28-06-2024,,2034,,89645.22
28-06-2024,UPI/418009236506/P2M/917875172127   vrlonline@/bl,28-06-2024,3928,,,85717.22
29-06-2024,UPI/418194888996/P2A//pepaymentpvtltd@iciciIRCTC E,29-06-2024,,2460.72,,88177.94
30-06-2024,UPI/418300116277/P2M/917875172127   punemetroc/adr,30-06-2024,22.5,,,88155.44
01-07-2024,UPI/418301705839/P2M/917875172127   punemetroc/adr,01-07-2024,22.5,,,88132.94
02-07-2024,NEFT_IN:BARBR24184824239/0035/ SANJAY BAPU KADAM,02-07-2024,,35000,,123132.94
03-07-2024,UPI/418501712081/P2M/917875172127   hotelroyal/uit,03-07-2024,500,,,122632.94
03-07-2024,UPI/418585299733/P2V/917875172127   komalborac/@ok,03-07-2024,28812,,,93820.94
05-07-2024,UPI/418703443635/P2M/917875172127   paytmqrg6z/rs0,05-07-2024,70,,,93750.94
05-07-2024,UPI/418770301876/P2M/917875172127   punemetroc/adr,05-07-2024,54,,,93696.94
05-07-2024,UPI/418771244893/P2M/917875172127   punemetroc/adr,05-07-2024,27,,,93669.94
07-07-2024,NEFT_IN:BARBR24189836513/0032/ SANJAY BAPU KADAM,07-07-2024,,10000,,103669.94
08-07-2024,UPI/419011814056/P2M/917875172127   innovdmart/h@i,08-07-2024,2352.82,,,101317.12
10-07-2024,NEFT_IN:BARBX24192080004/0020/ SANJAY BAPU KADAM,10-07-2024,,3000,,104317.12
14-07-2024,SMS CHRG FOR:01-04-2024to30-06-2024,14-07-2024,17.7,,,104299.42
15-07-2024,UPI/419793715790/P2M/917875172127   innovdmart/h@i,15-07-2024,2052.11,,,102247.31
15-07-2024,UPI/419793765837/P2M/917875172127   innovdmart/h@i,15-07-2024,694,,,101553.31
15-07-2024,UPI/419794953159/P2M/917875172127   paytmqr14g/ac@,15-07-2024,10,,,101543.31
16-07-2024,UPI/419824522037/P2M/917875172127   punemetroc/adr,16-07-2024,54,,,101489.31
16-07-2024,UPI/419825597683/P2M/917875172127   punemetroc/adr,16-07-2024,27,,,101462.31
16-07-2024,UPI/419848070582/P2M/917875172127   paytmqr1di/idr,16-07-2024,40,,,101422.31
17-07-2024,NEFT_IN:SBIN524199135859/0023/ ITDTAX REFUND 2024-25 FABPK3505G,17-07-2024,,1990,,103412.31
17-07-2024,UPI/419965689437/P2M/917875172127   punemetroc/adr,17-07-2024,27,,,103385.31
17-07-2024,UPI/419966422417/P2M/917875172127   punemetroc/adr,17-07-2024,27,,,103358.31
20-07-2024,NEFT_IN:BARBU24202708199/0027/ SANJAY BAPU KADAM,20-07-2024,,6000,,109358.31
20-07-2024,ATM WDR 420213008388 SHOP NO4 RAVI COMPLEX \,20-07-2024,3000,,,106358.31
20-07-2024,UPI/420205633182/P2M/paytmqr1owogiv6w1@paytm/Cloth,20-07-2024,70,,,106288.31
20-07-2024,UPI/420208839272/P2M/paytmqr14zkaa@paytm/Shree dat,20-07-2024,150,,,106138.31
20-07-2024,UPI/420219216586/P2M/q625607845@ybl/NITIN GANAPAT,20-07-2024,10,,,106128.31
20-07-2024,UPI/420285662699/P2M/q527432132@ybl/YOGIRAJ PRINTE,20-07-2024,14,,,106114.31
22-07-2024,UPI/420483748400/P2M/vrlonline@ybl/VIJAYANAND TRAV,22-07-2024,178,,,105936.31
23-07-2024,UPI/420509232392/P2M/netflixupi.payu@hdfcbank/NETF,23-07-2024,199,,,105737.31
23-07-2024,UPI/420518400601/P2M/q870785981@ybl/KK FOODS,23-07-2024,30,,,105707.31
23-07-2024,UPI/420518480344/P2M/gpay-11244316336@okbizaxis/Mi,23-07-2024,56,,,105651.31
24-07-2024,UPI/420651817709/P2M/gpay-11240802318@okbizaxis/Ma,24-07-2024,30,,,105621.31
24-07-2024,UPI/420660196626/P2M/vrlonline@axl/VIJAYANAND TRAV,24-07-2024,1517,,,104104.31
28-07-2024,NEFT_IN:BARBX24210159280/0038/ SANJAY BAPU KADAM,28-07-2024,,1500,,105604.31
29-07-2024,UPI/421149011752/P2M/gpay-11240810212@okbizaxis/Ma,29-07-2024,10,,,105594.31
01-08-2024,NEFT_IN:BARBT24214164524/0025/ SANJAY BAPU KADAM,01-08-2024,,1500,,107094.31
01-08-2024,ATM WDR 421409453712 YESHWANTPUR           \,01-08-2024,4000,,,103094.31
01-08-2024,UPI/458044702770/P2M/amazonpayhfc@rapl/Amazon Pay,01-08-2024,580,,,102514.31
02-08-2024,ATM WDR 421514029531 ++IISC ONSITE ONE     \,02-08-2024,5000,,,97514.31
06-08-2024,NEFT_IN:SBIN424219647585/0028/ IIT,06-08-2024,,10000,,107514.31
06-08-2024,1239010105996 To 123920PPF00000000032,06-08-2024,5000,,,102514.31
09-08-2024,UPI/422246428822/P2M/gpay-11245239530@okbizaxis/Ne,09-08-2024,3200,,,99314.31
22-08-2024,UPI/423514835599/P2M/bookmyshow@yespay/BOOKMYSHOW,22-08-2024,292.48,,,99021.83
23-08-2024,IMPS-IN/423621779717/9960152365/SANJAYBA,23-08-2024,,1500,,100521.83
23-08-2024,UPI/423621100751/P2M/netflixupi.payu@hdfcbank/NETF,23-08-2024,199,,,100322.83
29-08-2024,UPI/424290390577/P2M/paytmqr5ctmjn@ptys/MUTHA HOME,29-08-2024,70,,,100252.83
01-09-2024,NEFT_IN:BARBX24245929428/0044/ SANJAY BAPU KADAM,01-09-2024,,10000,,110252.83
01-09-2024,UPI/424516615406/P2V/9307558656@ybl/PRATHAMESH BHA,01-09-2024,750,,,109502.83
04-09-2024,UPI/424845976124/P2M/q143489866@ybl/RANJIT KAMAT,04-09-2024,80,,,109422.83
04-09-2024,UPI/424881432658/P2M/amazonupi@apl/Axis,04-09-2024,800,,,108622.83
07-09-2024,UPI/425182619730/P2M/dqrbp.46775005@axisbank/NESAR,07-09-2024,173,,,108449.83
08-09-2024,1239010105996:Int.Pd:01-06-2024 to 31-08-2024,08-09-2024,,76,,108525.83
11-09-2024,UPI/425564610341/P2M/gpay-11240835464@okbizaxis/Ra,11-09-2024,100,,,108425.83
15-09-2024,UPI/462570269032/P2V/kaulvishesh3@okaxis/VISHESH K,15-09-2024,,200,,108625.83
15-09-2024,UPI/425957102509/P2V/giamshuvadeep-1@okhdfcbank/SH,15-09-2024,,442,,109067.83
15-09-2024,UPI/425957012182/P2V/adityakatole2001@okhdfcbank/A,15-09-2024,,314,,109381.83
15-09-2024,UPI/425950964829/P2V/kaulvishesh3@okaxis/VISHESH K,15-09-2024,,440,,109821.83
21-09-2024,UPI/426501097544/P2V/giamshuvadeep-1@okhdfcbank/SH,21-09-2024,,138,,109959.83
22-09-2024,UPI/426662674735/P2M/irctc.cf@hdfcbank/IRCTC CF,22-09-2024,192.7,,,109767.13
22-09-2024,UPI/426663323254/P2M/irctc.cf@hdfcbank/IRCTC CF,22-09-2024,192.7,,,109574.43
23-09-2024,UPI/426776068972/P2M/gpayrecharge@okpayaxis/Google,23-09-2024,900.9,,,108673.53
24-09-2024,UPI/426820258398/P2M/gpay-11240835464@okbizaxis/Ra,24-09-2024,12,,,108661.53
27-09-2024,UPI/427281383099/P2V/goog-payments@axisbank/GOOGLE,27-09-2024,,6,,108667.53
29-09-2024,UPI/427396147863/P2M/amazonpaybalanceload@rapl/Ama,29-09-2024,400,,,108267.53
01-10-2024,NEFT_IN:BARBT24275282312/0033/ SANJAY BAPU KADAM,01-10-2024,,1500,,109767.53
02-10-2024,UPI/427690147920/P2M/paytmqr1blzw4du15@paytm/Bhava,02-10-2024,40,,,109727.53
06-10-2024,IMPS-IN/428018105226/7875172127/MANDAR S,06-10-2024,,8200,,117927.53
12-10-2024,SMS CHRG FOR:01-07-2024to30-09-2024,12-10-2024,17.7,,,117909.83
13-10-2024,ATM ANN.CHRG FOR CARD-1727 YEAR ENDED 2024-25,13-10-2024,177,,,117732.83
15-10-2024,UPI/428904294525/P2M/gpay-11240835464@okbizaxis/Ra,15-10-2024,90,,,117642.83
28-10-2024,UPI/430290963445/P2V/giamshuvadeep-1@okhdfcbank/SH,28-10-2024,,160,,117802.83
29-10-2024,UPI/479758310791/P2M/googlepay@axisbank/IRCTC,29-10-2024,,4495,,122297.83
29-10-2024,NEFT_IN:BARBQ24303651436/0016/ SANJAY BAPU KADAM,29-10-2024,,1500,,123797.83
01-11-2024,NEFT_IN:N306243370889900/0039/ MANDAR SANJAY KADAM,01-11-2024,40000,,,83797.83
02-11-2024,RCRADJ/430481615332/UPI,02-11-2024,,33.85,,83831.68
02-11-2024,UPI/430774555596/P2M/paytm-24889029@ptybl/BREVISTA,02-11-2024,771,,,83060.68
03-11-2024,UPI/430808953163/P2M/paytmqr1pge5enk5b@paytm/Bandh,03-11-2024,152,,,82908.68
03-11-2024,UPI/430879488290/P2M/q594015010@ybl/SHREE SATIMATA,03-11-2024,56,,,82852.68
03-11-2024,UPI/430883820537/P2A/520101266370788@ubin0911593./,03-11-2024,10200,,,72652.68
04-11-2024,NEFT_IN:BARBT24309657311/0046/ SANJAY BAPU KADAM,04-11-2024,,1500,,74152.68
04-11-2024,UPI/430925951284/P2M/q646700307@ybl/ASHOKAMORWADI,04-11-2024,110,,,74042.68
04-11-2024,UPI/430929903434/P2M/pinedmartmh@icici/AVENUE SUPE,04-11-2024,4340.55,,,69702.13
04-11-2024,UPI/430930944985/P2M/innovdmartmh@icici/AVENUE SUP,04-11-2024,727,,,68975.13
04-11-2024,UPI/430933767640/P2M/bharatpe.8q0b0d4q8o03448@fbp/,04-11-2024,50,,,68925.13
04-11-2024,UPI/430936088788/P2V/sarkarikhose@okhdfcbank/Mr. S,04-11-2024,70,,,68855.13
04-11-2024,UPI/430936245285/P2M/paytmqr14bh9s@paytm/MAHADEV T,04-11-2024,45,,,68810.13
05-11-2024,UPI/431095200134/P2M/mcdonalds.41102263@hdfcbank/M,05-11-2024,425.01,,,68385.12
06-11-2024,UPI/431141073246/P2M/ka57f1783@cnrb/BMTC BUS KA57F,06-11-2024,245,,,68140.12
07-11-2024,UPI/431268468834/P2M/yespay.mabs1204619ikit0190@y/,07-11-2024,100,,,68040.12
11-11-2024,UPI/431657040572/P2V/survesiddhi90@okaxis/SIDDHI A,11-11-2024,100,,,67940.12
15-11-2024,UPI/432010067630/P2M/airtelprepaidMahaGoa@mairtel/,15-11-2024,859,,,67081.12
16-11-2024,UPI/432117585835/P2M/q243516160@ybl/Sri Mookambika,16-11-2024,16,,,67065.12
16-11-2024,UPI/432118066876/P2V/bhatri.s.narayanan@okicici/S,16-11-2024,20,,,67045.12
16-11-2024,UPI/432118081795/P2V/8778106722@ptyes/MUKKESH KUMA,16-11-2024,117,,,66928.12
21-11-2024,UPI/432632687249/P2M/vijajanandtravels.bdpg@icici/,21-11-2024,1785,,,65143.12
22-11-2024,UPI/432766397831/P2V/kadamsanjay8871@okicici/SANJA,22-11-2024,1,,,65142.12
22-11-2024,UPI/432769197890/P2V/kadamsanjay8871@okicici/SANJA,22-11-2024,5000,,,60142.12
27-11-2024,UPI/433200438392/P2M/paytmqr1swkdgonul@paytm/VISAK,27-11-2024,30,,,60112.12
27-11-2024,UPI/433201933495/P2M/uberindiasystemsprivatelimit/,27-11-2024,37,,,60075.12
28-11-2024,UPI/433325652993/P2M/q594015010@ybl/SHREE SATIMATA,28-11-2024,102,,,59973.12
30-11-2024,UPI/433530050536/P2M/paytmqr281005050101o0bhd1qo1/,30-11-2024,230,,,59743.12
30-11-2024,UPI/433530353419/P2M/paytmqr5eosy1@ptys/NEW MEDIPH,30-11-2024,459,,,59284.12
01-12-2024,1239010105996:Int.Pd:01-09-2024 to 30-11-2024,01-12-2024,,103,,59387.12
02-12-2024,UPI/433703671040/P2M/amazonsellerservices.9839737/,02-12-2024,714,,,58673.12
02-12-2024,UPI/433721184971/P2M/paytmqr5kgpg5@ptys/Mr SHRIPAD,02-12-2024,70,,,58603.12
03-12-2024,UPI/433842661542/P2M/punemetroccadrandroi.7606732/,03-12-2024,22.5,,,58580.62
03-12-2024,UPI/433842679658/P2M/punemetroccadrandroi.7606732/,03-12-2024,22.5,,,58558.12
03-12-2024,UPI/433842725467/P2M/punemetrodynamicbqr.76071786/,03-12-2024,30,,,58528.12
03-12-2024,UPI/433844967106/P2M/q646700307@ybl/ASHOKAMORWADI,03-12-2024,70,,,58458.12
03-12-2024,UPI/433861372815/P2V/survesiddhi90@okaxis/SIDDHI A,03-12-2024,200,,,58258.12
03-12-2024,UPI/433867449746/P2M/amazonsellerservices.9839737/,03-12-2024,714,,,57544.12
03-12-2024,UPI/433870693846/P2M/paytmqr2810050501012kzajovcq/,03-12-2024,30,,,57514.12
04-12-2024,UPI/433998635246/P2V/survesiddhi90@okaxis/SIDDHI A,04-12-2024,1000,,,56514.12
05-12-2024,UPI/434082124031/P2M/q134752206@ybl/REAL SWEETS CO,05-12-2024,56,,,56458.12
06-12-2024,UPI/434102719688/P2M/q198608410@ybl/HOTEL LOKPRIYA,06-12-2024,70,,,56388.12
06-12-2024,UPI/434117744846/P2M/paytmqr1ajjzv2y8z@paytm/Salma,06-12-2024,40,,,56348.12
07-12-2024,UPI/434252605029/P2M/q198608410@ybl/HOTEL LOKPRIYA,07-12-2024,50,,,56298.12
07-12-2024,UPI/434296174151/P2M/amazonpaybalanceload@apl/Amaz,07-12-2024,258,,,56040.12
08-12-2024,UPI/434301353333/P2M/bookmyshow282710.rzp@rxairte/,08-12-2024,402.48,,,55637.64
10-12-2024,UPI/434521892839/P2M/q198608410@ybl/HOTEL LOKPRIYA,10-12-2024,70,,,55567.64
11-12-2024,UPI/434644233939/P2M/q198608410@ybl/HOTEL LOKPRIYA,11-12-2024,140,,,55427.64
13-12-2024,UPI/434829022037/P2V/akoli0412@ibl/ATUL RAJENDRA K,13-12-2024,2400,,,53027.64
14-12-2024,NEFT SANJAY BAPU KADAM,14-12-2024,40000,0,,13027.64
14-12-2024,UPI/434975932564/P2M/q716504290@ybl/Sujata Somnath,14-12-2024,20,,,13007.64
15-12-2024,UPI/435045631123/P2M/q191269498@ybl/NIMESHRAJENDRA,15-12-2024,50,,,12957.64
16-12-2024,UPI/498647293504/P2V/googlepay@axisbank/Google Pay,16-12-2024,,2,,12959.64
16-12-2024,UPI/498629973504/P2M/playstore@axisbank/Google Pla,16-12-2024,2,,,12957.64
